VOCABULARIO GENÉRICO (orden alfabético por traducción)

A

Abajo = hadan = 하단
Abanico = buche = 부채
Abrir = gaecho = 개초
Adentro = an = 안
Al frente = ap = 앞
Al lado = yeop = 옆
Al medio = jungdan = 중단
Alto = sangdan = 상단
Ánimo = yonggi = 용기
Antebrazo = palmok = 팔목
Arco = gung = 궁
Armas = mugi = 무기
Arriba = olligi = 올리기
Arrodillarse = mureup kkulgi = 무릎 꿇기
Asimilar al adversario y dirigir su movimiento = donghwa beop = 동화법
Atacante-agresor = gonggyeok ja = 공격자
Ataques = gonggyeok = 공격
Ausencia de mente = musim = 무심
Ambas piernas = modumbal = 모둠발

B

Bajo = arae = 아래
Bandera = gukgi = 국기
Bandera de Corea = taegeukgi = 태극기
Base = gibon = 기본
Base o bola del pie = chuk = 축
Básico = gicho = 기초
Básico de respiración = gicho hohup danjeon = 기초 호흡 단전
Bastón = danjang = 단장
Bloqueo = makgi = 막기
Boca manga = somae = 소매
Brazo = pal = 팔

C

Cadena de 7 secciones = chiljeolpyeon = 칠절편
Cambio = bakuda = 바꾸다
Cambio de ejercicio = bakkoseo = 바꿔서
Cambiar de pie = bal bakugi = 발 바꾸기
Camino, Unión, Estilo, Vereda = do = 도
Camino medio = jungdo = 중도
Cara = eolgul = 얼굴
Canto de la mano = sudo = 수도
Canto del pie = jokdo = 족도
Canto exterior = balnal = 발날
Canto exterior de la mano = sudo = 수도
Cielo = haneul = 하늘
Circular = dollyeo = 돌려
Código de los Guerreros = sesok ogye = 세속 오계
Combate = daeryeon = 대련
Combate prometido = yaksok daeryeon = 약속 대련
Combinación = bokshik = 복식
Con voz de mando = guryeong-e ttara = 구령에 따라
Concentración = muknyeom = 묵념
Contrario = bande = 반대
Continuar = gyesok = 계속
Correr / Rodar = gureugi = 구르기
Cortar = doligi = 돌리기
Costado = yeopguri = 옆구리
Cruzarse = gyocha = 교차
Cuchillo = dangeom = 단검

D

Dar la espalda = deung boigi = 등 보이기
Defensa = bangho = 방호
Defensor = bangho ja = 방호자
Descanso = swieo = 쉬어
Descendente = naeryeo = 내려
De frente = jeongmyeon = 정면
De lado = cheukbang = 측방
Despac io = cheoncheonhi = 천천히
Dispersar la energía del adversario = bunyok beop = 분욕법
Dobok / Uniforme = dobok = 도복
Dos dedos, como tijeras = igwan su = 이관수

E

Empezar = sijak = 시작
Empezar el entrenamiento = suryeon sijak = 수련 시작
Empujar = mireo = 밀어
Empujón = cha = 차
Energía = gi = 기
Espada = geom = 검
Especial = teuksu = 특수
Estilo de técnicas de palos = bong sul do = 봉술도

F

Flor = hwa = 화
Filo = nal = 날
Filo de la mano = sonnal = 손날
Filo externo = chokdo = 촉도
Firmes = charyeot = 차렷
Forma = hyeong = 형
Fórmula, Figura = pumsae = 품새

G

Golpe = chirugi = 치르기
Golpe con las piernas = jok = 족
Golpe con nudillo = jungji gwon = 중지권
Grado de Cinturón Negro = dan = 단
Grado de Cinturón de Color = geup = 급
Gracias = gomapseumnida = 고맙습니다
Grito – unión del espíritu = gihap = 기합
Giro = dari = 다리
Girar = dora = 돌아

H

Izquierdo = oen = 왼

L

La mano = son = 손
Lanza = chang = 창
Levantarse = ireoseoda = 일어서다
Luxaciones = gwanjeol gi = 관절기

M

Meditación = seon = 선
Meditación del paraíso = seongyeongji = 선경지
Meditación sobre las rodillas = danjwa = 단좌
Medio = jung = 중
Metatarso = ap chuk = 앞축
Modestia = gyeomson = 겸손

N

No = ani / anio = 아니 / 아니오
No hablar (silencio) = mukeun = 묵언
No más = geuman = 그만
Nuca = mogdeolmi = 목덜미

O

Oponente = bande ja = 반대자

P

Palma de la mano = batang = 바탕
Palo = bong = 봉
Palo corto = dan bong = 단봉
Palo largo = jang bong = 장봉
Parar = baro = 바로
Parte = pyeon = 편
Patada = chagi = 차기
Pierna = dari = 다리
Planta = balbadak = 발바닥
Posición = seogi = 서기
Posición adelantado = jeongul jase = 전굴 자세
Posición atrás = hugul jase = 후굴 자세
Posición media = gima jase = 기마자세
Preparados = gibon jase = 기본자세
Profesor = sabeomnim = 사범님
Puño = gwon / jumeok = 권 / 주먹

R

Rápido = ppareuge = 빠르게
Respeto = jon-gyeong = 존경

S

Saludo = gyeongnye = 경례
Saludo a las banderas = gukkidae gyeongnye = 국기대 경례
Sentado = anja = 앉아
Silencio = joyonghi = 조용히
Sistema de patadas = jok sul = 족술

T

Técnica = sul = 술
Técnicas de defensa personal = hoshin sul = 호신술
Técnicas de patadas = chagi sul = 차기술
Terminar el entrenamiento = suryeon kkeut = 수련 끝
Tierra = ttang = 땅
Tigre = beom = 범

U

Uniforme = dobok = 도복